111111111
102020201
111121111
101010101
101120201
101020101
101010101
102020201
101011211
102010201
111111111