1111111111111
1020201010201
1010101021211
1020202010101
1121212121201
1010202010201
1020212021111
1020102020201
1120112011211
1020202010201
1010202021201
1020201010201
1111111111111