111111111
101020101
111111201
102010201
101020211
101010201
112011211
102010101
112110111
101020101
111111111