111111111
101010101
101010201
102010101
112120201
102020101
112010101
101010201
111111111