1111111111111
1010102020101
1110201110111
1010202020201
1120111021101
1010101010201
1020111021111
1010102020101
1021112011211
1010101010201
1011212121111
1010102010201
1111111111111