11111111111
10202010101
10201020211
10101020101
10212021101
10201010101
11111111111