1111111
1010201
1121201
1020101
1020101
1020201
1110201
1020101
1111111