1111111
1020101
1110111
1010201
1011111
1010101
1111111
1010101
1111111