111111111
102020201
101011101
102010201
112021201
102020201
112010111
101020201
112020101
101020201
111111111