11111111111
10100000101
10100011101
10100000001
11101010101
10001010101
11101110101
10000000001
11111111111