1111111111111
1020201020101
1020202021211
1010202010101
1121112011111
1020201020101
1120212020201
1020202010201
1111111111111