1111111
1010201
1121101
1010101
1021101
1010101
1011101
1020101
1111111