1111111111111
1010102010101
1011202020111
1020201020201
1020111010211
1010101010201
1111111111111