11111111111
10202010101
11201020111
10102020101
10101011101
10101020201
10102110201
10102020201
11111111111