1111111111111
1020201020201
1021211120211
1020102010201
1120211010111
1010202010201
1120111110211
1010102010201
1011101110111
1020202010101
1111111111111