11111111111
10202010101
11212111101
10102020201
10112020201
10202010101
11201120201
10102020101
11111111111