1111111111111
1020101010201
1111201110101
1010201020101
1021101111201
1020101010101
1111111111111