1111111
1020201
1011201
1020101
1121101
1020101
1110111
1010201
1020201
1010101
1111111