1111111111111
1020101010201
1121102111111
1010201020201
1110102010201
1020101020201
1110201120201
1010101020101
1111201121201
1010202020201
1111111111111