111111111
101020201
101121111
102020101
112120201
102010201
102010111
102010201
111010101
101020201
111111111