1111111
1010101
1111111
1010101
1021211
1020101
1111111