11111111111
10202010101
10101110201
10202020101
10112011211
10102020201
10101111211
10201020201
10211010101
10202020101
11111111111