111111111
101010101
101010201
102010201
111111201
102010101
112121201
101020201
102011101
101020201
112110211
101010101
111111111