11111111111
10101010101
11112110201
10202010101
10112011211
10101020201
11202111111
10102010201
10211121211
10101010201
11111111111