1111111111111
1020202010101
1121212020111
1010201010201
1121101021101
1020201010201
1011211121211
1020201010101
1120212120211
1010101020201
1111111110201
1020101020201
1111111111111