1111111
1010101
1120101
1020201
1020101
1010101
1111111