11111111111
10202010101
10112110201
10102010201
10202010201
10201010201
11111111111