1111111
1010201
1120111
1020101
1010111
1020201
1120211
1010201
1111111