11111111111
10202010201
10112121111
10101020201
10101121211
10201010101
11201111201
10201010201
11111111111