11111111111
10201020201
10112121201
10201010201
11111110211
10102020201
11202111201
10201010201
11201021211
10202010201
11111111111