11111111111
10201020201
10101020201
10102010101
11201021211
10102010101
10101011211
10201020201
10111110211
10102020101
11111111111