11111111111
10102020101
11102020111
10101010201
10211021211
10202020201
10101021201
10201010201
11111111111