11111111111
10202020201
11101010111
10102020101
11211120101
10102020201
11202010201
10201010201
10212021111
10102020201
10101020201
10101020101
11111111111