1111111
1010101
1110111
1020201
1121211
1020101
1021211
1010101
1120101
1010101
1021201
1020201
1111111