1111111
1020101
1011121
1010101
1010121
1000201
1111111