1111111
1010101
1011111
1010101
1010111
1000101
1111111