111111111
100000001
101110111
101010101
101111111
100010101
101111101
101010001
111111111